10 5
T A A A A A A A A A
A W A A A M A A A M
A W A A A A A A A A
A W A A A M A A A A
A W W W A A A A A A